       __                     __   ________          __  
      / /   ____  _________ _/ /  / ____/ /_  ____ _/ /_ 
     / /   / __ \/ ___/ __ `/ /  / /   / __ \/ __ `/ __/ 
    / /___/ /_/ / /__/ /_/ / /  / /___/ / / / /_/ / /_   
   /_____/\____/\___/\__,_/_/   \____/_/ /_/\__,_/\__/   
         LocalChat developed by Dominic J Young 
  
                          Room 2 
 
